1111111111111111111111111111111111
1E00c00000000000000001000000000001
1000c1c100100000101001000000010101
1c00c10010101010001001000000010101
1000000000001000000000000000000001
100000000000000100P001000000000001
1010010100100000101001000000010101
1010010010101010001001000000010101
1e000000010010000000c0000000000001
1111111111111111111111111111111111