1111111111111111111111111111111111
1E00C00000000000000001000000000001
1000C1C100100000101001000000010101
1C00C10010101010001001000000010101
1000000000001000000000000000000001
100000000000000100P001000000000001
1010010100100000101001000000010101
1010010010101010001001000000010101
10000000010010000000C0000000000001
1111111111111111111111111111111111