1111111111111111111111111111111111
1E10c00000000000000001000000000001
1110c1c100100000101001000000010101
1c00c10010101010001001000000010101
1111111111111111111111111111111111