1111111111111111111111111111111111
1E10C00000000000000001000000000001
1110C1C100100000101001000000010101
1C00C10010101010001001000000010101
1111111111111111111111111111111111