1111111111111111111111111111111111
1E10C00000000000000001000000000001
1110C1C1001000001010010000000101011111
1C00C10010101010001001000000010101
1111111111111111111111111111111111